F 100,150,200
C 30,60,90
NO ./maps/textures/6.png
SO ./maps/textures/6.png
WE ./maps/textures/7.png
EA ./maps/textures/8.png

1111111111111111111111111111111111111111
1000000000000000000000000000000000000001
1011111111111111111111111111111111111101
1010000000000000000000000000000000000101
1010111111111111111111111111111111110101
1010100000000000000000000000000000010101
1010101111111111111111111111111111010101
1010101000000000000000000000000001010101
1010101011111111111111111111111101010101
1010101010000000000000000000000101010101
1010101010111111111111111111110101010101
1010101010100000000000000000010101010101
1010101010101111111111111111010101010101
1010101010101000000000000001010101010101
1010101010101011111111111101010101010101
1010101010101010000000000101010101010101
1010101010101010111111110101010101010101
1010101010101010100000010101010101010101
1010101010101010101111010101010101010101
1010101010101010101001010101010101010101
1010101010101010101111010101010101010101
1010101010101010100000010101010101010101
1010101010101010111111110101010101010101
1010101010101010000000000101010101010101
1010101010101011111111111101010101010101
1010101010101000000000000001010101010101
1010101010101111111111111111010101010101
1010101010100000000000000000010101010101
1010101010111111111111111111110101010101
1010101010000000000000000000000101010101
1010101011111111111111111111111101010101
1010101000000000000000000000000001010101
1010101111111111111111111111111111010101
1010100000000000000000000000000000010101
1010111111111111111111111111111111110101
1010000000000000000000000000000000000101
1011111111111111111111111111111111111101
1000000000000000000000000000000000000001
1N11111111111111111111111111111111111111
1111111111111111111111111111111111111111
