F 70,70,70
NO ./maps/textures/9.png
SO ./maps/textures/10.png
WE ./maps/textures/2.png
EA ./maps/textures/1.png
C 150,150,150

1111111111111111111111111111111111111111
1000000100000010000001000000100000010001
1011100101110010111001011100101110010001
1001000100010010001001000100100010010001
1001000111110011111001111100111110010001
1001000100000010000001000000100000010001
1001000101110010111001011100101110010001
1001000100010010001001000100100010010001
1001000111110011111001111100111110010001
1001000100000010000001000000100000010001
1001000101110010111001011100101110010001
1001000100010010001001000100100010010001
1001000111110011111001111100111110010001
1001000100000010000001000000100000010001
1001000101110010111001011100101110010001
1001000100010010001001000100100010010001
1001000111110011111001111100111110010001
1001000100000010000001000000100000010001
1001000101110010111001011100101110010001
1001000100010010001001000100100010010001
1001000111110011111001111100111110010001
1001000100000010000001000000100000010001
1001000101110010111001011100101110010001
1001000100010010001001000100100010010001
1001000111110011111001111100111110010001
1000000100000010000001000000100000010001
1011100101110010111001011100101110010001
1000100100010010001001000100100010010001
1111100111110011111001111100111110010001
1000000100000010000001000000100000010001
1011100101110010111001011100101110010001
1000100100010010001001000100100010010001
1111100111110011111001111100111110010001
1000000100000010000001000000100000010001
1011100101110010111001011100101110010001
1000100100010010001001000100100010010001
1111100111110011111001111100111110010001
1000000100000010000001000000100000010001
1E11100111110011111001111100111110011111
1111111111111111111111111111111111111111
