NO ./maps/textures/3.png
SO ./maps/textures/4.png
WE ./maps/textures/5.png
EA ./maps/textures/6.png
F 80,60,40
C 10,10,30

1111111111111111111111111111111111111111
100000000000000000000000000001111111111
100000000000000000000000000001000000001
100000000000000000000000000001000000001
100000000000000000000000000001000000001
100000000000000000000000000001000000001
100000000000000000000000000001000000001
100000000000000000000000000001000000001
100000000000000000000000000001000000001
100000000000000000000000000001000000001
100000000000000000000000000001000000001
100000000000000000000000000001000000001
100000000000000000000000000001000000001
100000000000000000000000000001000000001
100000000000000000000000000001000000001
100000000000000000000000000001000000001
1111111111111111111111111101111000000001
1000000000000000000000000000000000000001
1000000000000000000000000000000000000001
1000000000000000000000000000000000000001
1000000000000000000000000000000000000001
1000000000000000000000000000000000000001
1000000000000000000000000000000000000001
1000000000000000000000000000000000000001
1000000000000000000000000000000000000001
1000000000000000000000000000000000000001
1000000000000000000000000000000000000001
1000000000000000000000000000000000000001
1000000000000000000000000000000000000001
1000000000000000000000000000000000000001
1000000000000000000000000000000000000001
1000000000000000000000000000000000000001
1000000000000000000000000000000000000001
1000000000000000000000000000000000000001
1000000000000000000000000000000000000001
1000000000000000000000000000000000000001
1000000000000000000000000000000000000001
1000000000000000000000000000000000000001
1000000000000000000000000000000000000001
1W00000000000000000000000000000000000001
1111111111111111111111111111111111111111
