NO ./maps/textures/1.png
SO ./maps/textures/2.png
WE ./maps/textures/3.png
EA ./maps/textures/4.png
F 177,124,84
C 204,248,255

1111111111111
1000000000001
1001000001001
1000000000001
100000N000001
1000000011001
1000000011001
1000000000001
1111111111111
